1111111111111111111111111111111111111111111111111111111111111111
1111111111111111111111111111111111111111111111111111111111111111
1110000000000000000000000000011111100000000000000000000000000111
1110000000000000000000000000011111100000000000000000000000000111
1110000000000000000000000000011111100000000000000000000000000111
1110000000000000000000000000011111100000000000000000000000000111
1110000000000000000000000000011111100000000000000000000000000111
1110000000000000000000000000011111111111100000000000000000000111
1110000000000000000000000000011111111111100000000000000000000111
1110000000000000000000000000000000011111100000000000000000000111
1110000000000000000000000000000000011111100000000000000000000111
1110000000000000000000000000000000011111100000000000000000000111
1110000000000000000000000000000000011111100000000000000000000111
1110000000000000000000000000000000011111100000000000000000000111
1110000001111111111111100000000000011111111111111111100000000111
1110000001111111111111100000000000011111111111111111100000000111
1110000000000000000000000000000000000000000000000000000000000111
1110000000000000000000000000000000000000000000000000000000000111
1110000000000000000000000000000000000000000000000000000000000111
1110000000000000000000000000000000000000000000000000000000000111
1110000000000000000000000000000000000000000000000000000000000111
1110000000000000000000000000000000000000000000000000000000000111
1110000000000000000000000000000000000000000000000000000000000111
1110000000000000000000000000000000000000000000000000000000000111
1110000001111111111111100000000000011111111111111111100000000111
1110000001111111111111100000000000011111111111111111100000000111
1110000000000000000000000000000000000000000000000000000000000111
1110000000000000000000000000000000000000000000000000000000000111
1110000000000000000000000000000000000000000000000000000000000111
1110000000000000000000000000000000000000000000000000000000000111
1110000000000000000000000011111100000000000000000000000000000111
1110000000000000000000000011111100000000000000000000000000000111
1110000000000000000000000011111100000000000000000000000000000111
1110000000000000000000000011111100000000000000000000000000000111
1110000000000000000000000011111100000000000000000000000000000111
1110000000000000000000000011111111111100000000000000000000000111
1110000000000000000000000011111111111100000000000000000000000111
1110000000000000000000000000000011111100000000000000000000000111
1110000000000000000000000000000011111100000000000000000000000111
1110000000000000000000000000000011111100000000000000000000000111
1110000000000000000000000000000011111100000000000000000000000111
1110000000000000000000000000000011111100000000000000000000000111
1111111111111111111111111111111111111111111111111111111111111111
1111111111111111111111111111111111111111111111111111111111111111