1111111111111111111111111111111111111111111111111111111111111111
1111111111111111111111111111111111111111111111111111111111111111
1100000000000000000000000000000000000000000000000000000000000011
1100000000000000000000000000000000000000000000000000000000000011
1100000000000000000000000000000000000000000000000000000000000011
1100000000000000000000000000000000000000000000000000000000000011
1100000000000000000000000000000000000000000000000000000000000011
1100000000000000000000011111111111111111100000000000000000000011
1100000000000000000000011111111111111111100000000000000000000011
1100000000000000000000011111111111111111100000000000000000000011
1100000000000000000000011111111111111111100000000000000000000011
1100000000000000000000011111111111111111100000000000000000000011
1100000000000000000000011111111111111111100000000000000000000011
1100000000000000000000011111111111111111100000000000000000000011
1100000000000000000000011111111111111111100000000000000000000011
1100000000000000000000011111111111111111100000000000000000000011
1100000000000000000000000000000000000000000000000000000000000011
1100000000000000000000000000000000000000000000000000000000000011
1100000000000000000000000000000000000000000000000000000000000011
1100000000000000000000000000000000000000000000000000000000000011
1100000000000000000000000000000000000000000000000000000000000011
1100000000000000000000000000000000000000000000000000000000000011
1100000000000000000000000000000000000000000000000000000000000011
1100000001111111111111100000000000011111111111111111100000000011
1100000001111111111111100000000000011111111111111111100000000011
1100000000000000000000000000000000000000000000000000000000000011
1100000000000000000000000000000000000000000000000000000000000011
1100000000000000000000000000000000000000000000000000000000000011
1100000000000000000000000000000000000000000000000000000000000011
1100000000000000000000000000000000000000000000000000000000000011
1100000000000000000000000000000000000000000000000000000000000011
1100000000000000000000000011111100000000000000000000000000000011
1100000000000000000000000011111100000000000000000000000000000011
1100000000000000000000000011111100000000000000000000000000000011
1100000000000000000000000011111100000000000000000000000000000011
1100000000000000000000000011111100000000000000000000000000000011
1100000000000000000000000011111100000000000000000000000000000011
1100000000000000000000000000000000000000000000000000000000000011
1100000000000000000000000000000000000000000000000000000000000011
1100000000000000000000000000000000000000000000000000000000000011
1100000000000000000000000000000000000000000000000000000000000011
1100000000000000000000000000000000000000000000000000000000000011
1111111111111111111111111111111111111111111111111111111111111111
1111111111111111111111111111111111111111111111111111111111111111