1111111111111111111111111111111111111111111111111111111111111111
1111111111111111111111111111111111111111111111111111111111111111
1110000000000000000000000000000000000000000000000000000000000111
1110000000000000000000000000000000000000000000000000000000000111
1110000000000000000000000000000000000000000000000000000000000111
1110000000000000000000000000000000000000000000000000000000000111
1110000000000000000000000000000000000000000000000000000000000111
1110000000000000000000000000000000000000000000000000000000000111
1110000000000000000000000000000000000000000000000000000000000111
1110000000000000000000000000000000000000000000000000000000000111
1110000000000000000000000000000000000000000000000000000000000111
1110000000000000000000000000000000000000000000000000000000000111
1110000000111111111111110000000000000011111111111111000000000111
1110000000100000000000000000000000000010000000000000000000000111
1110000000100000000000000000000000000010000000000000000000000111
1110000000100000000000000000000000000010000000000000000000000111
1110000000100000000000000000000000000010000000000000000000000111
1110000000100000000000000000000000000010000000000000000000000111
1110000000100000000000000000000000000010000000000000000000000111
1110000000100000000000000000000000000010000000000000000000000111
1110000000100000000000000000000000000010000000000000000000000111
1110000000111111111111110000000000000011111111111111000000000111
1110000000100000000000000000000000000010000000000000000000000111
1110000000100000000000000000000000000010000000000000000000000111
1110000000100000000000000000000000000010000000000000000000000111
1110000000100000000000000000000000000010000000000000000000000111
1110000000100000000000000000000000000010000000000000000000000111
1110000000100000000000000000000000000010000000000000000000000111
1110000000100000000000000000000000000010000000000000000000000111
1110000000100000000000000000000000000010000000000000000000000111
1110000000111111111111110000000000000011111111111111000000000111
1110000000000000000000000000000000000000000000000000000000000111
1110000000000000000000000000000000000000000000000000000000000111
1110000000000000000000000000000000000000000000000000000000000111
1110000000000000000000000000000000000000000000000000000000000111
1110000000000000000000000000000000000000000000000000000000000111
1110000000000000000000000000000000000000000000000000000000000111
1110000000000000000000000000000000000000000000000000000000000111
1110000000000000000000000000000000000000000000000000000000000111
1110000000000000000000000000000000000000000000000000000000000111
1110000000000000000000000000000000000000000000000000000000000111
1110000000000000000000000000000000000000000000000000000000000111
1111111111111111111111111111111111111111111111111111111111111111
1111111111111111111111111111111111111111111111111111111111111111