1111111111111111111111111111111111111111111111111111111111111111
1111111111111111111111111111111111111111111111111111111111111111
1110000000000000000000000000000000000000000000000000000000000111
1110000000000000000000000000000000000000000000000000000000000111
1110000000000000000000000000000000000000000000000000000000000111
1110000000000000000000000000000000000000000000000000000000000111
1110000000000000000000000000000000000000000000000000000000000111
1110000000000000000000000000000000000000000000000000000000000111
1110000000001111100000000111111100000000000000000000000000000111
1110000000000010000000000100000000000000000000000000000000000111
1110000000000010000000000100000000000000000000000000000000000111
1110000000000010000000000100000000000000000000000000000000000111
1110000000000010000000000100000000000000000000000000000000000111
1110000000000010000000000100000000000000000000000000000000000111
1110000000001111100000000111111100000000000000000000000000000111
1110000000000000000000000000000000000000000000000000000000000111
1110000000000000000000000000000000000000000000000000000000000111
1110000000000000000000000000000000000000000000000000000000000111
1110000000000000000000000000000000000000000000000000000000000111
1110000000000000000000000000000000000000000000000000000000000111
1110000000000000000000000000000000000000000000000000000000000111
1110000000000000000000000000000000000000000000000000000000000111
1110000000000000000000000000000000000000000000000000000000000111
1110000000000000000000000000000000000000000000000000000000000111
1110000000000000000000000111111100000000000000000000000000000111
1110000000000000000000000100000000000000000000000000000000000111
1110000000000000000000000100000000000000000000000000000000000111
1110000000000000000000000100000000000000000000000000000000000111
1110000000000000000000000100000000000000000000000000000000000111
1110000000000000000000000100000000000010000000000000000000000111
1110000000000000000000000111111100000000000000111111111000000111
1110000000000000000000000100000000000010000000010000001000000111
1110000000000000000000000100000000000010000000010000001000000111
1110000000000000000000000100000000000010000000010000001000000111
1110000000000000000000000100000000000010000000010000001000000111
1110000000000000000000000000000000000000000000000000000000000111
1110000000000000000000000000000000000000000000000000000000000111
1110000000000000000000000000000000000000000000000000000000000111
1110000000000000000000000000000000000000000000000000000000000111
1110000000000000000000000000000000000000000000000000000000000111
1110000000000000000000000000000000000000000000000000000000000111
1110000000000000000000000000000000000000000000000000000000000111
1111111111111111111111111111111111111111111111111111111111111111
1111111111111111111111111111111111111111111111111111111111111111