1111111111111111111111111111111111111111111111111111111111111111
1111111111111111111111111111111111111111111111111111111111111111
1110000000000000100000000010000000001000000000100000000000000111
1110000000000000100000000010000000001000000000100000000000000111
1110000000000000000000000000000000000000000000000000000000000111
1110000000000000000000000000000000000000000000000000000000000111
1110000000000000000000000000000000000000000000000000000000000111
1110000000000000000000000000000000000000000000000000000000000111
1110000000000000000000000000000000000000000000000000000000000111
1110000000000000000000000000000000000000000000000000000000000111
1110000000000000000000000000000000000000000000000000000000000111
1110000000000000000000000000000000000000000000000000000000000111
1110000000000000000000000000000100000000000000000000000000000111
1110000000000000000000000000000100000000000000000000000000000111
1110000000000000000000000000000100000000000000000000000000000111
1110000000000000000000000000000000000000000000000000000000000111
1110000000000000000000000000000000000000000000000000000000000111
1110000000000000000000000000000000000000000000000000000000000111
1110000000000000000000000000000000000000000000000000000000000111
1110000000000000000000000000000000000000000000000000000000000111
1110000000000000000000000000000000000000000000000000000000000111
1110000000000000000000000000000000000000000000000000000000000111
1110000000000000000000000000000000000000000000000000000000000111
1110000000000000000000000000000000000000000000000000000000000111
1110000000000000000000000000000000000000000000000000000000000111
1110000000000000000000000000000100000000000000000000000000000111
1110000000000000000000000000000100000000000000000000000000000111
1110000000000000000000000000000100000000000000000000000000000111
1110000000000000000000000000000000000000000000000000000000000111
1110000000000000000000000000000000000000000000000000000000000111
1110000000000000000000000000000000000000000000000000000000000111
1110000000000000000000000000000000000000000000000000000000000111
1110000000000000000000000000000000000000000000000000000000000111
1110000000000000000000000000000000000000000000000000000000000111
1110000000000000000000000000000000000000000000000000000000000111
1110000000000000000000000000000000000000000000000000000000000111
1110000000000000000000000000000000000000000000000000000000000111
1110000000000000000000000000000000000000000000000000000000000111
1110000000000000000000000000000000000000000000000000000000000111
1110000000000000000000000000000000000000000000000000000000000111
1110000000000000100000000010000000001000000000100000000000000111
1110000000000000100000000010000000001000000000100000000000000111
1111111111111111111111111111111111111111111111111111111111111111
1111111111111111111111111111111111111111111111111111111111111111