1111111111111111111111111111111111111111111111111111111111111111
1111111111111111111111111111111111111111111111111111111111111111
1110000000000000000000000000000000000000000000000000000000000111
1110000000000000000000000000000000000000000000000000000000000111
1110000000000000000000000000000000000000000000000000000000000111
1110000000000000000000000000000000000000000000000000000000000111
1110000000000000000000000000000000000000000000000000000000000111
1110000000000011111110000000000000001111111000000000000000000111
1110000000000010000000000000000000000000001000000000000000000111
1110000000000010000000000000000000000000001000000000000000000111
1110000000000010000000000000000000000000001000000000000000000111
1110000000000010000000000010001000000000001000000000000000000111
1110000000000010000000000001010000000000001000000000000000000111
1110000000000011111110000000100000001111111000000000000000000111
1110000000000000000010000001010000000000001000000000000000000111
1110000000000000000010000010001000000000001000000000000000000111
1110000000000000000010000000000000000000001000000000000000000111
1110000000000000000010000000000000000000001000000000000000000111
1110000000000000000010000000000000000000001000000000000000000111
1110000000000011111110000000000000001111111000000000000000000111
1110000000000000000000000000000000000000000000000000000000000111
1110000000000000000000000000000000000000000000000000000000000111
1110000000000000000000000000000000000000000000000000000000000111
1110000000000000000000000000000000000000000000000000000000000111
1110000000000000000000000000000000000000000000000000000000000111
1110000000000000000000000000000000100000000011111111000000000111
1110000000000000000000000000000000100000000010000000000000000111
1110000000000000000000000000000000100000000010000000000000000111
1110000000000000000000000000000000100000000010000000000000000111
1110000000000000000111111000000000100000000010000000000000000111
1110000000000000000000000000000000100000000011111111000000000111
1110000000000000000111111000000000100000000000000001000000000111
1110000000000000000000000000000000100000000000000001000000000111
1110000000000000000000000000000000100000000000000001000000000111
1110000000000000000000000000000000100000000000000001000000000111
1110000000000000000000000000000000100000000000000001000000000111
1110000000000000000000000000000000100000000011111111000000000111
1110000000000000000000000000000000000000000000000000000000000111
1110000000000000000000000000000000000000000000000000000000000111
1110000000000000000000000000000000000000000000000000000000000111
1110000000000000000000000000000000000000000000000000000000000111
1110000000000000000000000000000000000000000000000000000000000111
1111111111111111111111111111111111111111111111111111111111111111
1111111111111111111111111111111111111111111111111111111111111111